下弧	aiyp
武当赵堡太极拳	akbn
武晓龙	akhg
袁军	bjwh
赵堡太极	bngf
赵堡	bonj
起势	bydq
云手	bzmd
去了	bzyv
王雄	cagz
麸质	crpe
搏命	dfoa
推手	dnmd
搬拦	dpdu
蓝村	ekfd
古汉语	evxs
莲莲	ewew
李笑来	fmmb
李仁贵	fnbj
李兴贺	fvay
李武	fyah
李刚	fylk
李随成	fywh
有氧	gqmu
戒色	hery
划圈	hkju
战力	ijym
上步	ivik
路西法	jfjv
回锅肉	jpjl
咏春	jsco
同阶	ldyo
网盘	lopl
短板	mafp
生抽	mcdk
知乎	mjmu
简书	mtxy
白鹤	nkwn
自启动	nwjb
白鹤亮翅	nwse
微信	olns
谷智鑫	omjp
斜行	omoi
金师	paka
金老师	pbrk
鹞步	pmik
冬荫功	reyb
鲶鱼	rora
解决方法	rtsv
高探马	sdwx
竞速	sjwf
夜路	snjr
变强	sxyj
应甫臣	tfbh
魔戒	tfhe
冯焰	txur
拳架	umyj
前侧	uqnl
焖烧	utuh
汪涛	vcvc
沉没成本	vvhf
肩与胯合	waqo
遥步	wpik
迅雷	wyfk
鸡柳	xrfr
书单	xyuk
阿飞	yayt
加课	yjsk
孙宁	ykwa
费俊超	ynzb
除了	yoyv
纸笔	zrmm
发你	zvnr
文泉驿	snkx
